XXXXXXXXXX
X....X...X
X.T...oT.X
Xo.XXXXX.X
XT..X.o..X
XXX...X.TX
X.....X.oX
X.XTXXXT.X
X..o.....X
XXXXXXXXXX