XXXXXXXXXX
X...X...oX
X.X...T..X
X.oXXXXX.X
XT...TT..X
XXX..XX.XX
X....T..oX
X.TXXX.XTX
X..o.....X
XXXXXXXXXX