XXXXXXXXXX
Xo.T.....X
X.XX..XXTX
XTXX..XXoX
X........X
X..XXXXX.X
X.T......X
X..XXXXTTX
Xo....XToX
XXXXXXXXXX