XXXXXXXXXX
XT..o...TX
X.TXX..X.X
X.XX..XXoX
X.TT.....X
X.XX...XXX
XoXo.X.X.X
X.X.XX.X.X
X...T....X
XXXXXXXXXX