XXXXXXXXXX
X.....oXXX
XoXXXX..TX
X.XXXXTX.X
X......XoX
XXXXTT.X.X
X..XoT...X
X.XXXXXTTX
X..T..T..X
XXXXXXXXXX