XXXXXXXXXX
XoT.T.T.TX
XT.T.T.ToX
XoT.T.T.TX
XT.T.T.ToX
XoT.T.T.TX
XT.T.T.ToX
XoT.T.T.TX
XT.T.T.ToX
XXXXXXXXXX